1111111
1100E11
11PC010
1111111
