11111111
1C000001
11110001
100000E1
10001111
10P01001
11111111
