111111
1P00C1
1000l1
10E0K1
111111
