11111111
1CC00001
11110001
1C0000E1
10001111
10P01001
11111111
