1111111111111
1KlBBEBl0C011
1l111KB011011
10BBKlBl11P11
101111lClB011
1C11111lBB011
1111111111111
