111111111111
11000BC00E11
11P110101111
11111C0B1111
111111111111
