11111111
1PBC00E1
11010111
11C0B111
11111111
