1111111111
1CCC100001
1CCC100001
1CCC100001
1101100101
1000000101
1P000001E1
1111111111
