11111111
1P000C11
10000011
10110011
10CC00E1
11111111
