111111111
100000001
100000001
1000E0001
100000001
1C0000001
1111P1111
111111111
