1111111111
1111111111
11lBCB1C11
1B011EB001
1Bl11B11l1
11ClBBBlK1
11lBBPBBB1
1111111111
1111111111
