1111111
1E111C1
1PlCK01
1111C11
1111111
