111111111111
1P000BC00E01
101110101111
11111C0B1111
111111111111
