11111111
1E111111
10111111
10B1BBB1
1l0l0lC1
1B111111
1CB00111
111P1111
11111111
