11111111
1P000001
11110C01
10CC0001
10001111
1E001001
11111111
